1111111111111
10E100000N001
10C0010111001
10P0110C00001
1111111111111
