1111111111111
10E1000000001
10C0010111001
10P0110C00001
1111111111111
