1111111111111111111111111
1PEC000000000000000000001
1000000000000000000000001
1000000000000000000000001
1000000000000000000000001
1000000000C00000000000001
1000000000000000000000001
1000000000000000000000001
1000000000000000000000001
1000000000000000000000001
10000000C0000000000000001
10000000000000000000C0001
1000000000000000000000001
1000C0000000C000000000001
1111111111111111111111111
